//MAP CONVERTED BY dmm2tgm.py THIS HEADER COMMENT PREVENTS RECONVERSION, DO NOT REMOVE
"at" = (
/turf/open/misc/dirt/jungle,
/area/deathmatch/fullbright)
"aF" = (
/obj/structure/flora/bush/reed,
/turf/open/water/jungle,
/area/deathmatch/fullbright)
"aI" = (
/obj/structure/flora/grass/jungle/a/style_3,
/turf/open/misc/grass/jungle,
/area/deathmatch/fullbright)
"bg" = (
/obj/structure/flora/tree/jungle/style_2,
/turf/open/misc/grass/jungle,
/area/deathmatch/fullbright)
"bu" = (
/obj/structure/flora/rock/pile/jungle/style_5,
/turf/open/water/jungle,
/area/deathmatch/fullbright)
"bG" = (
/obj/structure/flora/grass/jungle,
/turf/open/misc/grass/jungle,
/area/deathmatch/fullbright)
"cr" = (
/obj/structure/flora/grass/jungle/a/style_5,
/turf/open/misc/dirt/jungle,
/area/deathmatch/fullbright)
"cv" = (
/obj/structure/flora/bush/leavy/style_2,
/turf/open/misc/dirt/jungle/dark,
/area/deathmatch/fullbright)
"dJ" = (
/obj/structure/flora/bush/large,
/turf/open/misc/grass/jungle,
/area/deathmatch/fullbright)
"ea" = (
/obj/structure/flora/tree/jungle/small,
/turf/open/misc/grass/jungle,
/area/deathmatch/fullbright)
"ex" = (
/turf/open/misc/dirt/jungle/dark,
/area/deathmatch/fullbright)
"fJ" = (
/obj/structure/flora/bush/ferny/style_2,
/turf/open/misc/grass/jungle,
/area/deathmatch/fullbright)
"fV" = (
/obj/structure/flora/ash/stem_shroom,
/turf/open/misc/dirt/jungle/dark,
/area/deathmatch/fullbright)
"gr" = (
/obj/structure/flora/rock/pile,
/turf/open/misc/dirt/jungle,
/area/deathmatch/fullbright)
"gZ" = (
/obj/structure/flora/grass/jungle/a,
/turf/open/misc/dirt/jungle,
/area/deathmatch/fullbright)
"hH" = (
/turf/closed/indestructible/rock,
/area/deathmatch/fullbright)
"hM" = (
/obj/structure/flora/ash/leaf_shroom,
/turf/open/misc/dirt/jungle,
/area/deathmatch/fullbright)
"jh" = (
/obj/structure/flora/tree/jungle/small/style_5,
/turf/open/misc/grass/jungle,
/area/deathmatch/fullbright)
"ju" = (
/obj/structure/flora/grass/jungle/a,
/turf/open/misc/grass/jungle,
/area/deathmatch/fullbright)
"jB" = (
/turf/open/water/jungle,
/area/deathmatch/fullbright)
"ka" = (
/obj/structure/flora/grass/jungle/a/style_3,
/turf/open/misc/dirt/jungle,
/area/deathmatch/fullbright)
"kd" = (
/obj/structure/flora/bush/fullgrass/style_3,
/turf/open/misc/dirt/jungle,
/area/deathmatch/fullbright)
"kh" = (
/obj/structure/firepit,
/turf/open/misc/dirt/jungle/dark,
/area/deathmatch/fullbright)
"kr" = (
/obj/structure/flora/rock/pile/style_3,
/turf/open/misc/dirt/jungle/dark,
/area/deathmatch/fullbright)
"ku" = (
/obj/effect/landmark/deathmatch_player_spawn,
/turf/open/misc/grass/jungle,
/area/deathmatch/fullbright)
"mk" = (
/obj/structure/flora/tree/jungle/style_3,
/turf/open/misc/grass/jungle,
/area/deathmatch/fullbright)
"mz" = (
/obj/structure/flora/bush/large/style_3,
/turf/open/misc/grass/jungle,
/area/deathmatch/fullbright)
"nb" = (
/obj/structure/flora/grass/jungle/a/style_2,
/turf/open/misc/dirt/jungle,
/area/deathmatch/fullbright)
"nm" = (
/obj/structure/flora/bush/sparsegrass,
/turf/open/misc/grass/jungle,
/area/deathmatch/fullbright)
"nH" = (
/obj/structure/flora/rock/pile/style_3,
/turf/open/misc/grass/jungle,
/area/deathmatch/fullbright)
"nV" = (
/turf/closed/mineral/gold,
/area/deathmatch/fullbright)
"oa" = (
/turf/open/misc/grass/jungle,
/area/deathmatch/fullbright)
"pe" = (
/obj/structure/flora/grass/jungle,
/turf/open/misc/dirt/jungle,
/area/deathmatch/fullbright)
"pt" = (
/obj/structure/flora/rock/pile/jungle/style_2,
/turf/open/water/jungle,
/area/deathmatch/fullbright)
"qx" = (
/obj/structure/flora/grass/jungle,
/turf/open/misc/dirt/jungle/dark,
/area/deathmatch/fullbright)
"qT" = (
/obj/structure/flora/rock/pile/jungle/style_3,
/turf/open/misc/dirt/jungle,
/area/deathmatch/fullbright)
"sF" = (
/obj/structure/flora/grass/jungle/a/style_4,
/turf/open/misc/dirt/jungle/dark,
/area/deathmatch/fullbright)
"sM" = (
/obj/structure/flora/bush/grassy/style_3,
/turf/open/misc/grass/jungle,
/area/deathmatch/fullbright)
"us" = (
/obj/structure/flora/grass/jungle/b/style_5,
/turf/open/misc/dirt/jungle,
/area/deathmatch/fullbright)
"ve" = (
/obj/structure/flora/bush/ferny/style_3,
/turf/open/water/jungle,
/area/deathmatch/fullbright)
"vK" = (
/obj/structure/flora/grass/jungle/b/style_2,
/turf/open/misc/dirt/jungle,
/area/deathmatch/fullbright)
"wa" = (
/obj/structure/flora/bush/fullgrass,
/turf/open/misc/grass/jungle,
/area/deathmatch/fullbright)
"wn" = (
/obj/structure/flora/tree/jungle/small/style_6,
/turf/open/misc/grass/jungle,
/area/deathmatch/fullbright)
"wu" = (
/obj/structure/flora/grass/jungle/a/style_2,
/turf/open/misc/grass/jungle,
/area/deathmatch/fullbright)
"xd" = (
/obj/structure/flora/bush/generic/style_3,
/turf/open/misc/dirt/jungle,
/area/deathmatch/fullbright)
"yW" = (
/obj/structure/flora/bush/grassy/style_4{
	pixel_y = -10
	},
/turf/open/misc/grass/jungle,
/area/deathmatch/fullbright)
"yZ" = (
/obj/structure/flora/bush/reed/style_4,
/turf/open/water/jungle,
/area/deathmatch/fullbright)
"zU" = (
/obj/structure/flora/rock/pile/jungle/style_3,
/turf/open/water/jungle,
/area/deathmatch/fullbright)
"Aj" = (
/obj/structure/flora/bush/ferny/style_3,
/turf/open/misc/grass/jungle,
/area/deathmatch/fullbright)
"AG" = (
/obj/structure/flora/rock/pile,
/turf/open/misc/dirt/jungle/dark,
/area/deathmatch/fullbright)
"Cn" = (
/obj/structure/flora/rock/pile,
/turf/open/misc/grass/jungle,
/area/deathmatch/fullbright)
"CY" = (
/obj/structure/flora/tree/jungle/small/style_4,
/turf/open/misc/dirt/jungle/dark,
/area/deathmatch/fullbright)
"Ds" = (
/obj/structure/flora/bush/jungle/c,
/turf/open/misc/grass/jungle,
/area/deathmatch/fullbright)
"DM" = (
/obj/structure/flora/rock/pile/jungle,
/turf/open/water/jungle,
/area/deathmatch/fullbright)
"EB" = (
/obj/structure/flora/bush/reed/style_4,
/turf/open/misc/dirt/jungle,
/area/deathmatch/fullbright)
"Fe" = (
/obj/item/food/grown/bungofruit,
/obj/structure/flora/bush/ferny/style_3,
/turf/open/misc/grass/jungle,
/area/deathmatch/fullbright)
"FL" = (
/obj/structure/flora/grass/jungle/a/style_5,
/turf/open/misc/grass/jungle,
/area/deathmatch/fullbright)
"Gf" = (
/obj/effect/decal/cleanable/ants/fire{
	name = "fire ants"
	},
/turf/open/misc/dirt/jungle/dark,
/area/deathmatch/fullbright)
"GS" = (
/obj/structure/flora/rock/pile/jungle/style_2,
/turf/open/misc/grass/jungle,
/area/deathmatch/fullbright)
"Ha" = (
/obj/effect/decal/cleanable/ants/fire{
	name = "fire ants"
	},
/turf/open/misc/dirt/jungle,
/area/deathmatch/fullbright)
"Hd" = (
/obj/structure/flora/tree/jungle/small/style_6,
/obj/structure/flora/bush/fullgrass/style_3,
/turf/open/misc/grass/jungle,
/area/deathmatch/fullbright)
"Id" = (
/obj/structure/flora/rock/pile/jungle,
/turf/open/misc/dirt/jungle,
/area/deathmatch/fullbright)
"Ih" = (
/obj/structure/flora/grass/jungle/a/style_4,
/turf/open/misc/grass/jungle,
/area/deathmatch/fullbright)
"IE" = (
/obj/structure/flora/rock/pile/style_2,
/turf/open/misc/dirt/jungle,
/area/deathmatch/fullbright)
"IX" = (
/obj/structure/flora/bush/jungle/a,
/turf/open/misc/grass/jungle,
/area/deathmatch/fullbright)
"Ji" = (
/obj/structure/flora/bush/stalky/style_2,
/turf/open/misc/grass/jungle,
/area/deathmatch/fullbright)
"KB" = (
/obj/structure/flora/rock/style_4,
/turf/open/misc/grass/jungle,
/area/deathmatch/fullbright)
"Lw" = (
/obj/effect/landmark/deathmatch_player_spawn,
/turf/open/misc/dirt/jungle/dark,
/area/deathmatch/fullbright)
"Lz" = (
/obj/effect/landmark/deathmatch_player_spawn,
/turf/open/misc/dirt/jungle,
/area/deathmatch/fullbright)
"LE" = (
/obj/structure/flora/rock/pile/jungle/style_4,
/turf/open/misc/dirt/jungle/dark,
/area/deathmatch/fullbright)
"LG" = (
/obj/structure/flora/bush/reed/style_3,
/turf/open/water/jungle,
/area/deathmatch/fullbright)
"Mb" = (
/obj/structure/flora/rock/pile/jungle/style_2,
/turf/open/misc/dirt/jungle/dark,
/area/deathmatch/fullbright)
"Mk" = (
/obj/structure/flora/rock,
/turf/open/misc/dirt/jungle,
/area/deathmatch/fullbright)
"Mv" = (
/obj/structure/flora/grass/jungle/a/style_5,
/turf/open/misc/dirt/jungle/dark,
/area/deathmatch/fullbright)
"NG" = (
/obj/structure/flora/bush/leafy,
/turf/open/misc/grass/jungle,
/area/deathmatch/fullbright)
"NO" = (
/obj/structure/flora/grass/jungle/a/style_3,
/turf/open/misc/dirt/jungle/dark,
/area/deathmatch/fullbright)
"Oe" = (
/obj/structure/flora/tree/jungle/small/style_2,
/turf/open/misc/grass/jungle,
/area/deathmatch/fullbright)
"Pg" = (
/obj/structure/flora/rock/style_4,
/turf/open/misc/dirt/jungle,
/area/deathmatch/fullbright)
"PW" = (
/obj/structure/flora/bush/leafy,
/turf/open/misc/dirt/jungle/dark,
/area/deathmatch/fullbright)
"QD" = (
/obj/structure/flora/rock/pile/jungle/style_4,
/turf/open/water/jungle,
/area/deathmatch/fullbright)
"QR" = (
/obj/structure/flora/rock,
/turf/open/misc/dirt/jungle/dark,
/area/deathmatch/fullbright)
"QU" = (
/obj/structure/flora/rock/style_3,
/turf/open/misc/grass/jungle,
/area/deathmatch/fullbright)
"QV" = (
/obj/structure/firepit,
/turf/open/misc/dirt/jungle,
/area/deathmatch/fullbright)
"Rc" = (
/obj/structure/flora/ash/cap_shroom,
/turf/open/misc/dirt/jungle/dark,
/area/deathmatch/fullbright)
"RA" = (
/obj/structure/flora/bush/fullgrass/style_2,
/turf/open/misc/grass/jungle,
/area/deathmatch/fullbright)
"RH" = (
/obj/structure/flora/bush/fullgrass/style_3,
/turf/open/misc/grass/jungle,
/area/deathmatch/fullbright)
"Tc" = (
/obj/structure/flora/tree/jungle/small/style_5,
/turf/open/misc/dirt/jungle/dark,
/area/deathmatch/fullbright)
"Tu" = (
/obj/structure/flora/grass/jungle/b/style_3,
/turf/open/misc/dirt/jungle,
/area/deathmatch/fullbright)
"Up" = (
/obj/structure/flora/bush/stalky/style_3,
/turf/open/misc/dirt/jungle,
/area/deathmatch/fullbright)
"UK" = (
/obj/structure/flora/ash/tall_shroom,
/turf/open/misc/dirt/jungle/dark,
/area/deathmatch/fullbright)
"UO" = (
/obj/structure/flora/bush/reed/style_2,
/turf/open/water/jungle,
/area/deathmatch/fullbright)
"UV" = (
/obj/structure/flora/tree/jungle,
/turf/open/misc/dirt/jungle/dark,
/area/deathmatch/fullbright)
"Vo" = (
/obj/structure/flora/grass/jungle/a/style_2,
/turf/open/misc/dirt/jungle/dark,
/area/deathmatch/fullbright)
"VF" = (
/obj/structure/flora/bush/ferny/style_3,
/turf/open/misc/dirt/jungle,
/area/deathmatch/fullbright)
"XS" = (
/obj/item/clothing/accessory/talisman,
/obj/structure/flora/rock/style_4,
/turf/open/misc/dirt/jungle/dark,
/area/deathmatch/fullbright)
"XX" = (
/obj/structure/flora/bush/lavendergrass/style_3,
/turf/open/misc/dirt/jungle,
/area/deathmatch/fullbright)
"Ys" = (
/obj/structure/flora/bush/leavy/style_3,
/turf/open/misc/grass/jungle,
/area/deathmatch/fullbright)
"ZA" = (
/obj/structure/flora/rock/pile/jungle,
/turf/open/misc/dirt/jungle/dark,
/area/deathmatch/fullbright)
"ZY" = (
/obj/structure/flora/grass/jungle/b/style_2,
/turf/open/misc/grass/jungle,
/area/deathmatch/fullbright)
"ZZ" = (
/obj/structure/flora/grass/jungle/a/style_4,
/turf/open/misc/dirt/jungle,
/area/deathmatch/fullbright)

(1,1,1) = {"
hH
hH
hH
hH
hH
hH
hH
hH
hH
hH
hH
hH
hH
hH
hH
hH
hH
hH
hH
hH
hH
hH
hH
hH
hH
hH
"}
(2,1,1) = {"
hH
nV
nV
nV
nV
nV
nV
jB
jB
jB
pe
at
ZZ
jB
jB
jB
jB
jB
jB
jB
jB
jB
jB
at
wa
hH
"}
(3,1,1) = {"
hH
nV
nV
nV
nV
nV
LG
jB
nV
nV
nV
at
nV
nV
nV
pt
jB
jB
jB
aF
jB
jB
cr
oa
oa
hH
"}
(4,1,1) = {"
hH
nV
nV
nV
nV
gr
at
at
hM
nV
nV
at
VF
nV
nV
nV
yZ
jB
mz
wa
jB
jB
bu
RH
jB
hH
"}
(5,1,1) = {"
hH
nV
nV
nV
Lz
at
QV
at
at
at
at
IE
at
cr
nV
nV
nV
jB
Hd
XX
oa
ku
jB
aF
jB
hH
"}
(6,1,1) = {"
hH
nV
nV
UK
at
at
at
gZ
nV
nV
nV
Up
oa
at
IE
Id
oa
jB
LG
RA
at
cr
RH
jB
jB
hH
"}
(7,1,1) = {"
hH
nV
nV
ea
Mv
at
at
nV
nV
nV
nV
bg
ju
oa
Mk
oa
oa
Ys
jB
oa
gr
at
qT
jB
jB
hH
"}
(8,1,1) = {"
hH
nV
nV
Aj
oa
ex
ex
nV
nV
nV
Fe
Ji
oa
oa
oa
oa
kd
Ha
oa
oa
oa
ZZ
LG
jB
jB
hH
"}
(9,1,1) = {"
hH
jB
fJ
mk
Ih
ex
at
gr
nV
nV
QU
oa
oa
oa
oa
oa
oa
RH
FL
oa
aF
jB
jB
pt
jB
hH
"}
(10,1,1) = {"
hH
jB
KB
NG
ex
ex
ka
cr
nV
nV
oa
oa
vK
at
oa
oa
oa
oa
oa
oa
ex
jB
QD
at
jB
hH
"}
(11,1,1) = {"
hH
jB
oa
ex
ex
ex
IX
ZZ
at
at
nb
oa
QD
pt
at
dJ
wn
Mv
oa
oa
ex
jB
jB
at
jB
hH
"}
(12,1,1) = {"
hH
yZ
oa
nV
ex
ex
FL
ZZ
EB
oa
Ha
ex
cr
oa
oa
IX
dJ
ex
oa
oa
Vo
ex
jB
jB
jB
hH
"}
(13,1,1) = {"
hH
jB
nV
nV
QR
ex
Aj
gZ
at
Pg
pt
cr
nH
Tu
oa
oa
RH
oa
oa
oa
oa
QR
jB
DM
jB
hH
"}
(14,1,1) = {"
hH
LG
nV
nV
Tc
ex
oa
oa
xd
at
jB
oa
ZZ
at
at
pt
oa
oa
oa
oa
oa
CY
cv
jB
jB
hH
"}
(15,1,1) = {"
hH
LE
nV
nV
wu
ex
oa
oa
oa
jh
Ds
oa
oa
sF
ex
ex
Mv
oa
ju
oa
oa
oa
ex
LG
jB
hH
"}
(16,1,1) = {"
hH
ex
nV
nV
oa
oa
oa
oa
oa
oa
Ih
oa
yW
QU
at
jB
jB
oa
oa
Cn
oa
oa
ex
jB
jB
hH
"}
(17,1,1) = {"
hH
ZA
nV
Mb
ex
oa
oa
sM
oa
oa
ZY
wu
oa
ex
oa
oa
QD
ex
oa
oa
oa
oa
Vo
yZ
jB
hH
"}
(18,1,1) = {"
hH
ex
nV
UV
AG
ex
nV
nV
aI
oa
GS
ZY
us
ex
oa
oa
ve
ex
ex
oa
bG
ex
ex
jB
jB
hH
"}
(19,1,1) = {"
hH
ex
ex
XS
ex
ex
nV
nV
Vo
ex
oa
oa
oa
ex
Gf
oa
jB
jB
ex
oa
oa
NO
ex
jB
jB
hH
"}
(20,1,1) = {"
hH
Mb
ex
ex
ex
ex
qx
ex
ex
ex
ex
nm
bg
oa
oa
ex
Mv
oa
oa
oa
oa
ex
ex
jB
jB
hH
"}
(21,1,1) = {"
hH
nV
nV
UK
ex
ex
ex
ex
ex
Mv
nV
Aj
Ji
oa
nV
nV
ex
PW
oa
oa
Cn
ex
Vo
jB
jB
hH
"}
(22,1,1) = {"
hH
nV
nV
nV
Lw
ex
ex
kh
ex
ex
nV
nV
jh
nV
nV
zU
UO
oa
Oe
oa
oa
Lw
aF
DM
jB
hH
"}
(23,1,1) = {"
hH
nV
nV
nV
nV
kr
ex
ex
ex
Rc
nV
nV
nV
nV
nV
jB
jB
jB
FL
oa
fV
jB
jB
jB
jB
hH
"}
(24,1,1) = {"
hH
nV
nV
nV
nV
nV
nV
nV
nV
nV
nV
nV
nV
nV
nV
aF
bu
jB
aF
jB
jB
jB
pt
jB
cr
hH
"}
(25,1,1) = {"
hH
nV
nV
nV
nV
nV
nV
nV
nV
nV
nV
nV
ka
at
jB
jB
jB
jB
jB
jB
jB
jB
jB
jB
at
hH
"}
(26,1,1) = {"
hH
hH
hH
hH
hH
hH
hH
hH
hH
hH
hH
hH
hH
hH
hH
hH
hH
hH
hH
hH
hH
hH
hH
hH
hH
hH
"}
