//MAP CONVERTED BY dmm2tgm.py THIS HEADER COMMENT PREVENTS RECONVERSION, DO NOT REMOVE
"aa" = (
/obj/effect/spawner/structure/window/reinforced/shuttle,
/obj/effect/mapping_helpers/damaged_window,
/obj/machinery/door/poddoor/shutters{
	id = "bustedfoodtruck_backroom_shutters";
	dir = 4
	},
/turf/open/floor/plating,
/area/shuttle/ruin/busted_foodtruck)
"ab" = (
/obj/effect/decal/cleanable/dirt/dust,
/obj/structure/rack,
/obj/item/pushbroom,
/obj/item/reagent_containers/spray/cleaner,
/turf/open/floor/catwalk_floor/iron_smooth,
/area/shuttle/ruin/busted_foodtruck)
"af" = (
/obj/structure/sign/poster/official/midtown_slice/directional/south,
/obj/effect/decal/cleanable/dirt,
/obj/effect/decal/cleanable/food/egg_smudge{
	pixel_y = 7;
	pixel_x = -7
	},
/turf/open/floor/mineral/titanium,
/area/shuttle/ruin/busted_foodtruck)
"ag" = (
/obj/structure/tank_dispenser/oxygen,
/turf/open/floor/catwalk_floor/iron_smooth,
/area/shuttle/ruin/busted_foodtruck)
"ah" = (
/obj/effect/mapping_helpers/airlock/cutaiwire,
/obj/machinery/door/airlock/vault{
	normalspeed = 0;
	name = "Secure Door";
	desc = "An imposing looking door. It looks reinforced."
	},
/turf/open/floor/iron/smooth,
/area/shuttle/ruin/busted_foodtruck)
"aj" = (
/obj/machinery/power/shuttle_engine/heater,
/turf/closed/wall/mineral/titanium,
/area/shuttle/ruin/busted_foodtruck)
"al" = (
/obj/structure/railing{
	dir = 4
	},
/turf/open/floor/mineral/titanium,
/area/shuttle/ruin/busted_foodtruck)
"ao" = (
/obj/structure/sign/poster/ripped/directional/north,
/turf/open/floor/mineral/titanium,
/area/shuttle/ruin/busted_foodtruck)
"bY" = (
/turf/open/floor/iron/kitchen/small,
/area/shuttle/ruin/busted_foodtruck)
"cm" = (
/obj/structure/lattice,
/obj/structure/marker_beacon/burgundy,
/turf/template_noop,
/area/shuttle/ruin/busted_foodtruck)
"dg" = (
/obj/structure/closet/secure_closet/freezer/empty,
/obj/machinery/light/dim/directional/east,
/obj/item/reagent_containers/cup/soda_cans/random,
/turf/open/floor/iron/kitchen/small,
/area/shuttle/ruin/busted_foodtruck)
"dB" = (
/obj/structure/closet/chefcloset,
/obj/effect/turf_decal/siding/dark{
	dir = 8
	},
/turf/open/floor/mineral/titanium,
/area/shuttle/ruin/busted_foodtruck)
"dJ" = (
/obj/item/food/classic_hard_shell_taco{
	pixel_x = 2;
	pixel_y = 10
	},
/obj/item/food/classic_hard_shell_taco{
	pixel_y = 8
	},
/obj/item/food/classic_hard_shell_taco{
	pixel_y = 6;
	pixel_x = -2
	},
/obj/item/food/classic_hard_shell_taco{
	pixel_y = 4;
	pixel_x = -4
	},
/obj/item/food/classic_hard_shell_taco{
	pixel_y = 2;
	pixel_x = -6
	},
/obj/item/food/classic_hard_shell_taco{
	pixel_x = -8
	},
/obj/structure/closet/crate/secure/freezer,
/obj/structure/sign/poster/contraband/donut_corp/directional/north,
/turf/open/floor/mineral/titanium,
/area/shuttle/ruin/busted_foodtruck)
"ev" = (
/obj/effect/turf_decal/siding/dark{
	dir = 8
	},
/turf/open/floor/mineral/titanium,
/area/shuttle/ruin/busted_foodtruck)
"eA" = (
/obj/machinery/vending/medical{
	onstation_override = 1
	},
/obj/machinery/airalarm/directional/west,
/turf/open/floor/iron/smooth,
/area/shuttle/ruin/busted_foodtruck)
"eP" = (
/obj/machinery/light/dim/directional/north,
/obj/machinery/button/door{
	id = "foodtruck_right_window";
	pixel_x = 6;
	name = "SHUTTERS - R"
	},
/obj/machinery/button/door{
	id = "foodtruck_left_window";
	pixel_x = -6;
	name = "SHUTTERS - L"
	},
/obj/effect/decal/cleanable/dirt/dust,
/obj/structure/table/reinforced,
/turf/open/floor/catwalk_floor/iron_smooth,
/area/shuttle/ruin/busted_foodtruck)
"fo" = (
/obj/structure/table/reinforced,
/obj/item/plate,
/obj/item/reagent_containers/condiment/curry_powder{
	pixel_y = 5;
	pixel_x = -7
	},
/turf/open/floor/iron/smooth,
/area/shuttle/ruin/busted_foodtruck)
"gc" = (
/obj/effect/decal/cleanable/dirt/dust,
/obj/structure/sign/poster/ripped/directional/south,
/turf/open/floor/iron/smooth,
/area/shuttle/ruin/busted_foodtruck)
"gs" = (
/obj/structure/cable,
/obj/effect/decal/cleanable/dirt/dust,
/obj/effect/turf_decal/siding/dark{
	dir = 8
	},
/obj/effect/turf_decal/siding/dark{
	dir = 4
	},
/turf/open/floor/iron/smooth,
/area/shuttle/ruin/busted_foodtruck)
"gv" = (
/obj/structure/closet/crate/secure/freezer,
/obj/item/food/fries{
	pixel_x = 5;
	pixel_y = -2
	},
/obj/item/food/raw_meatball{
	pixel_y = 4;
	pixel_x = 8
	},
/obj/item/reagent_containers/condiment/soymilk{
	pixel_y = -2;
	pixel_x = -8
	},
/obj/machinery/button/door/directional/west,
/turf/open/floor/iron/smooth,
/area/shuttle/ruin/busted_foodtruck)
"hB" = (
/obj/machinery/power/shuttle_engine/propulsion,
/turf/template_noop,
/area/shuttle/ruin/busted_foodtruck)
"iO" = (
/obj/structure/noticeboard/directional/north,
/obj/effect/decal/cleanable/dirt,
/turf/open/floor/mineral/titanium,
/area/shuttle/ruin/busted_foodtruck)
"jb" = (
/obj/machinery/light/dim/directional/south,
/obj/structure/cable,
/obj/effect/turf_decal/siding/dark{
	dir = 1
	},
/turf/open/floor/iron/smooth,
/area/shuttle/ruin/busted_foodtruck)
"jc" = (
/obj/machinery/light/floor,
/obj/structure/table/reinforced,
/obj/structure/railing{
	dir = 4
	},
/obj/effect/turf_decal/siding/dark{
	dir = 4
	},
/turf/open/floor/mineral/titanium,
/area/shuttle/ruin/busted_foodtruck)
"jw" = (
/obj/structure/rack,
/obj/item/radio/off,
/turf/open/floor/catwalk_floor/iron_smooth,
/area/shuttle/ruin/busted_foodtruck)
"jA" = (
/obj/structure/chair/comfy/shuttle/tactical{
	dir = 1
	},
/obj/structure/cable,
/obj/effect/turf_decal/siding/dark/end{
	dir = 1
	},
/turf/open/floor/iron/smooth,
/area/shuttle/ruin/busted_foodtruck)
"kf" = (
/obj/effect/turf_decal/box,
/turf/closed/wall/mineral/titanium/nodiagonal,
/area/shuttle/ruin/busted_foodtruck)
"kj" = (
/obj/effect/decal/cleanable/dirt,
/turf/open/floor/iron/kitchen/small,
/area/shuttle/ruin/busted_foodtruck)
"ku" = (
/turf/closed/wall/mineral/titanium/nodiagonal,
/area/shuttle/ruin/busted_foodtruck)
"kv" = (
/obj/machinery/door/window/brigdoor/right/directional/east{
	req_access = list("syndicate")
	},
/obj/effect/turf_decal/caution/stand_clear{
	dir = 8
	},
/obj/effect/turf_decal/bot,
/obj/effect/turf_decal/siding/dark{
	dir = 4
	},
/obj/effect/turf_decal/siding/dark{
	dir = 4
	},
/turf/open/floor/mineral/titanium,
/area/shuttle/ruin/busted_foodtruck)
"lX" = (
/obj/item/reagent_containers/condiment/flour{
	pixel_y = 6;
	pixel_x = -6
	},
/obj/effect/decal/cleanable/dirt/dust,
/turf/open/floor/mineral/titanium,
/area/shuttle/ruin/busted_foodtruck)
"mT" = (
/obj/structure/cable,
/obj/machinery/power/smes,
/turf/open/floor/catwalk_floor/iron_smooth,
/area/shuttle/ruin/busted_foodtruck)
"nh" = (
/obj/structure/sign/poster/ripped/directional/south,
/turf/open/floor/mineral/titanium,
/area/shuttle/ruin/busted_foodtruck)
"oA" = (
/obj/structure/railing{
	dir = 8
	},
/obj/effect/turf_decal/arrows{
	pixel_y = 16
	},
/turf/open/floor/mineral/titanium,
/area/shuttle/ruin/busted_foodtruck)
"pQ" = (
/obj/machinery/computer/shuttle/hunter{
	req_access = list("syndicate")
	},
/obj/structure/cable,
/turf/open/floor/catwalk_floor/iron_smooth,
/area/shuttle/ruin/busted_foodtruck)
"pU" = (
/obj/machinery/griddle,
/obj/effect/decal/cleanable/dirt,
/turf/open/floor/mineral/titanium,
/area/shuttle/ruin/busted_foodtruck)
"pZ" = (
/obj/structure/railing/corner{
	dir = 1
	},
/turf/open/floor/mineral/titanium,
/area/shuttle/ruin/busted_foodtruck)
"sN" = (
/obj/structure/table/reinforced,
/obj/machinery/computer/security/telescreen/entertainment/directional/north,
/obj/structure/railing{
	dir = 4
	},
/obj/item/reagent_containers/condiment/vinegar{
	pixel_y = 9
	},
/obj/item/reagent_containers/condiment/mayonnaise{
	pixel_x = 5;
	pixel_y = 6
	},
/obj/item/reagent_containers/condiment/ketchup{
	pixel_x = -5;
	pixel_y = 6
	},
/obj/item/reagent_containers/condiment/saltshaker{
	pixel_x = -2;
	pixel_y = -3
	},
/obj/item/reagent_containers/condiment/peppermill{
	pixel_y = -4;
	pixel_x = 4
	},
/obj/effect/turf_decal/siding/dark{
	dir = 4
	},
/turf/open/floor/mineral/titanium,
/area/shuttle/ruin/busted_foodtruck)
"sZ" = (
/obj/effect/spawner/structure/window/reinforced/shuttle,
/obj/machinery/door/poddoor/shutters{
	id = "bustedfoodtruck_backroom_shutters";
	dir = 4
	},
/turf/open/floor/plating,
/area/shuttle/ruin/busted_foodtruck)
"te" = (
/obj/structure/fans/tiny,
/obj/docking_port/mobile{
	name = "food truck";
	rechargeTime = 1800;
	dir = 4;
	shuttle_id = "busted_foodtruck";
	port_direction = 8
	},
/obj/effect/turf_decal/stripes{
	dir = 8
	},
/obj/effect/decal/cleanable/dirt,
/obj/machinery/door/poddoor/shutters{
	id = "bustedfoodtruck_shutters";
	dir = 8
	},
/turf/open/floor/plating,
/area/shuttle/ruin/busted_foodtruck)
"tW" = (
/turf/open/floor/mineral/titanium,
/area/shuttle/ruin/busted_foodtruck)
"ua" = (
/obj/structure/sign/poster/contraband/donk_co/directional/south,
/obj/effect/decal/cleanable/dirt/dust,
/turf/open/floor/mineral/titanium,
/area/shuttle/ruin/busted_foodtruck)
"ui" = (
/obj/structure/table/reinforced,
/obj/structure/sign/poster/contraband/eat/directional/east,
/turf/open/floor/iron/kitchen/small,
/area/shuttle/ruin/busted_foodtruck)
"uq" = (
/obj/structure/table/reinforced,
/obj/structure/railing{
	dir = 4
	},
/obj/effect/turf_decal/siding/dark{
	dir = 4
	},
/obj/effect/decal/cleanable/dirt,
/turf/open/floor/mineral/titanium,
/area/shuttle/ruin/busted_foodtruck)
"vC" = (
/obj/effect/decal/cleanable/dirt/dust,
/turf/open/floor/iron/smooth,
/area/shuttle/ruin/busted_foodtruck)
"we" = (
/obj/machinery/power/apc/auto_name/directional/south{
	cable_layer = 1
	},
/obj/structure/cable,
/obj/effect/decal/cleanable/dirt/dust,
/obj/effect/turf_decal/siding/dark/corner{
	dir = 4
	},
/obj/effect/turf_decal/siding/dark/corner{
	dir = 1
	},
/turf/open/floor/iron/smooth,
/area/shuttle/ruin/busted_foodtruck)
"wA" = (
/obj/structure/lattice/catwalk,
/turf/template_noop,
/area/shuttle/ruin/busted_foodtruck)
"xg" = (
/obj/structure/chair/comfy/shuttle/tactical{
	dir = 1
	},
/obj/effect/decal/cleanable/dirt/dust,
/obj/structure/cable,
/obj/effect/turf_decal/siding/dark/end{
	dir = 1
	},
/turf/open/floor/iron/smooth,
/area/shuttle/ruin/busted_foodtruck)
"xG" = (
/obj/structure/railing/corner{
	dir = 8
	},
/obj/effect/decal/cleanable/dirt/dust,
/turf/open/floor/mineral/titanium,
/area/shuttle/ruin/busted_foodtruck)
"yn" = (
/obj/structure/table/reinforced,
/obj/effect/turf_decal/siding/dark{
	dir = 8
	},
/turf/open/floor/mineral/titanium,
/area/shuttle/ruin/busted_foodtruck)
"zJ" = (
/turf/open/floor/iron/smooth,
/area/shuttle/ruin/busted_foodtruck)
"Ak" = (
/obj/machinery/computer/camera_advanced/shuttle_docker/syndicate/hunter{
	x_offset = 6;
	y_offset = 1
	},
/obj/effect/decal/cleanable/dirt/dust,
/obj/structure/cable,
/turf/open/floor/catwalk_floor/iron_smooth,
/area/shuttle/ruin/busted_foodtruck)
"Am" = (
/obj/structure/lattice,
/turf/template_noop,
/area/shuttle/ruin/busted_foodtruck)
"An" = (
/obj/effect/spawner/structure/window/reinforced/shuttle,
/obj/structure/cable/layer1,
/obj/machinery/door/poddoor{
	id = "foodtruck_right_window"
	},
/turf/open/floor/plating,
/area/shuttle/ruin/busted_foodtruck)
"Ay" = (
/obj/machinery/griddle,
/obj/effect/decal/cleanable/dirt/dust,
/obj/effect/turf_decal/siding/dark{
	dir = 8
	},
/turf/open/floor/mineral/titanium,
/area/shuttle/ruin/busted_foodtruck)
"AF" = (
/obj/structure/fans/tiny,
/obj/effect/turf_decal/stripes{
	dir = 8
	},
/obj/machinery/door/poddoor/shutters{
	id = "bustedfoodtruck_shutters";
	dir = 8
	},
/turf/open/floor/plating,
/area/shuttle/ruin/busted_foodtruck)
"AP" = (
/obj/effect/turf_decal/arrows,
/obj/structure/railing{
	dir = 8
	},
/turf/open/floor/mineral/titanium,
/area/shuttle/ruin/busted_foodtruck)
"Bn" = (
/obj/structure/table/reinforced,
/turf/open/floor/mineral/titanium,
/area/shuttle/ruin/busted_foodtruck)
"CY" = (
/obj/machinery/deepfryer,
/obj/structure/noticeboard/directional/north,
/obj/effect/decal/cleanable/dirt,
/turf/open/floor/iron/kitchen/small,
/area/shuttle/ruin/busted_foodtruck)
"Dp" = (
/obj/effect/turf_decal/arrows{
	dir = 8;
	pixel_x = 16
	},
/obj/structure/railing/corner{
	dir = 4
	},
/obj/effect/decal/cleanable/dirt/dust,
/turf/open/floor/mineral/titanium,
/area/shuttle/ruin/busted_foodtruck)
"Ev" = (
/obj/effect/spawner/structure/window/reinforced/shuttle,
/obj/machinery/door/poddoor{
	id = "foodtruck_left_window"
	},
/turf/open/floor/plating,
/area/shuttle/ruin/busted_foodtruck)
"Fv" = (
/obj/structure/table/reinforced,
/obj/machinery/microwave,
/obj/machinery/light/dim/directional/west,
/obj/structure/sign/poster/contraband/little_fruits/directional/west,
/turf/open/floor/iron/smooth,
/area/shuttle/ruin/busted_foodtruck)
"IG" = (
/obj/structure/marker_beacon/burgundy,
/obj/structure/lattice,
/turf/template_noop,
/area/shuttle/ruin/busted_foodtruck)
"Jv" = (
/obj/machinery/airalarm/directional/south,
/obj/structure/cable,
/obj/effect/decal/cleanable/dirt/dust,
/obj/effect/turf_decal/siding/dark/corner{
	dir = 4
	},
/obj/effect/turf_decal/siding/dark/corner{
	dir = 1
	},
/turf/open/floor/iron/smooth,
/area/shuttle/ruin/busted_foodtruck)
"KV" = (
/obj/effect/decal/cleanable/dirt/dust,
/turf/open/floor/mineral/titanium,
/area/shuttle/ruin/busted_foodtruck)
"Lm" = (
/obj/machinery/vending/dinnerware,
/obj/machinery/airalarm/directional/east,
/turf/open/floor/iron/kitchen/small,
/area/shuttle/ruin/busted_foodtruck)
"LY" = (
/obj/effect/turf_decal/siding/dark{
	dir = 1
	},
/turf/open/floor/iron/smooth,
/area/shuttle/ruin/busted_foodtruck)
"Ml" = (
/obj/structure/table/reinforced,
/obj/machinery/reagentgrinder,
/obj/effect/decal/cleanable/dirt,
/obj/machinery/light/floor,
/turf/open/floor/mineral/titanium,
/area/shuttle/ruin/busted_foodtruck)
"MZ" = (
/obj/machinery/oven/range,
/obj/effect/turf_decal/siding/dark{
	dir = 8
	},
/turf/open/floor/mineral/titanium,
/area/shuttle/ruin/busted_foodtruck)
"NJ" = (
/obj/effect/decal/cleanable/dirt/dust,
/turf/open/floor/iron/kitchen/small,
/area/shuttle/ruin/busted_foodtruck)
"Pq" = (
/turf/template_noop,
/area/template_noop)
"PE" = (
/obj/effect/decal/cleanable/dirt,
/turf/open/floor/iron/smooth,
/area/shuttle/ruin/busted_foodtruck)
"QV" = (
/obj/effect/mapping_helpers/airlock/cutaiwire,
/obj/machinery/door/airlock/vault{
	normalspeed = 0;
	name = "Secure Door";
	desc = "An imposing looking door. It looks reinforced."
	},
/turf/open/floor/mineral/titanium,
/area/shuttle/ruin/busted_foodtruck)
"RO" = (
/obj/machinery/button/door/directional/east{
	id = "bustedfoodtruck_shutters";
	name = "External Shutter Switch"
	},
/obj/structure/table/reinforced,
/obj/effect/decal/cleanable/dirt/dust,
/turf/open/floor/iron/kitchen/small,
/area/shuttle/ruin/busted_foodtruck)
"Sw" = (
/obj/machinery/door/airlock/vault{
	normalspeed = 0;
	name = "Secure Door";
	desc = "An imposing looking door. It looks reinforced."
	},
/obj/effect/mapping_helpers/airlock/cutaiwire,
/turf/open/floor/iron/smooth,
/area/shuttle/ruin/busted_foodtruck)
"SP" = (
/obj/structure/table/reinforced,
/turf/open/floor/catwalk_floor/iron_smooth,
/area/shuttle/ruin/busted_foodtruck)
"UF" = (
/obj/machinery/door/airlock/external{
	name = "Fire Escape";
	desc = "If you really need to escape in a hurry, try this door.";
	id_tag = "foodtruck_firescape"
	},
/obj/structure/fans/tiny,
/obj/effect/mapping_helpers/airlock/locked,
/obj/effect/mapping_helpers/airlock/cutaiwire,
/turf/open/floor/mineral/titanium,
/area/shuttle/ruin/busted_foodtruck)
"Xc" = (
/obj/effect/turf_decal/arrows{
	dir = 4
	},
/obj/structure/railing/corner,
/turf/open/floor/mineral/titanium,
/area/shuttle/ruin/busted_foodtruck)
"XE" = (
/obj/machinery/button/door/directional/east{
	id = "foodtruck_firescape";
	normaldoorcontrol = 1;
	specialfunctions = 4;
	pixel_y = -10;
	name = "Fire Escape Bolt Switch"
	},
/obj/machinery/suit_storage_unit,
/turf/open/floor/catwalk_floor/iron_smooth,
/area/shuttle/ruin/busted_foodtruck)
"Yi" = (
/obj/effect/decal/cleanable/dirt/dust,
/obj/effect/decal/cleanable/dirt,
/turf/open/floor/mineral/titanium,
/area/shuttle/ruin/busted_foodtruck)
"YW" = (
/obj/structure/table/reinforced,
/obj/structure/railing{
	dir = 4
	},
/obj/effect/turf_decal/siding/dark{
	dir = 4
	},
/obj/effect/decal/cleanable/dirt/dust,
/turf/open/floor/mineral/titanium,
/area/shuttle/ruin/busted_foodtruck)

(1,1,1) = {"
Pq
Pq
Pq
Pq
Pq
ku
AF
AF
te
AF
AF
AF
ku
Pq
Pq
"}
(2,1,1) = {"
Pq
Pq
Pq
cm
Am
ku
ao
Xc
al
al
Dp
ua
ku
IG
Pq
"}
(3,1,1) = {"
Pq
Pq
Pq
Pq
wA
ku
iO
xG
oA
AP
pZ
nh
ku
aj
hB
"}
(4,1,1) = {"
cm
Ev
Ev
ku
ku
ku
sN
jc
uq
YW
jc
kv
ku
aj
hB
"}
(5,1,1) = {"
Ev
Ev
jw
ab
LY
Sw
bY
kj
NJ
NJ
bY
bY
ku
cm
Pq
"}
(6,1,1) = {"
Ev
Ak
jA
gs
Jv
ku
CY
ui
dg
Lm
kj
RO
ku
Pq
Pq
"}
(7,1,1) = {"
ku
eP
SP
mT
jb
ku
ku
ku
ku
ku
QV
kf
ku
Pq
Pq
"}
(8,1,1) = {"
An
pQ
xg
gs
we
ku
eA
zJ
Fv
fo
vC
gv
ku
Pq
Pq
"}
(9,1,1) = {"
An
An
ag
XE
LY
ah
zJ
zJ
PE
PE
vC
gc
ku
cm
Pq
"}
(10,1,1) = {"
cm
An
An
ku
UF
ku
dB
ev
MZ
yn
Ay
ev
ku
aj
hB
"}
(11,1,1) = {"
Pq
Pq
Pq
Pq
wA
ku
dJ
KV
Ml
Bn
pU
tW
ku
aj
hB
"}
(12,1,1) = {"
Pq
Pq
Pq
cm
Am
ku
lX
KV
Yi
tW
tW
af
ku
IG
Pq
"}
(13,1,1) = {"
Pq
Pq
Pq
Pq
Pq
ku
aa
sZ
sZ
aa
sZ
sZ
ku
Pq
Pq
"}
